"filename", "language", "C++", "Makefile", "Markdown", "comment", "blank", "total"
"/home/ljc/Desktop/Retro/Makefile", "Makefile", 0, 24, 0, 0, 3, 27
"/home/ljc/Desktop/Retro/config/config.cc", "C++", 65, 0, 0, 10, 11, 86
"/home/ljc/Desktop/Retro/config/config.h", "C++", 22, 0, 0, 10, 15, 47
"/home/ljc/Desktop/Retro/http/http_event.cc", "C++", 526, 0, 0, 36, 74, 636
"/home/ljc/Desktop/Retro/http/http_event.h", "C++", 139, 0, 0, 0, 10, 149
"/home/ljc/Desktop/Retro/log/block_queue.cc", "C++", 47, 0, 0, 0, 8, 55
"/home/ljc/Desktop/Retro/log/block_queue.h", "C++", 23, 0, 0, 0, 10, 33
"/home/ljc/Desktop/Retro/log/log.cc", "C++", 98, 0, 0, 1, 14, 113
"/home/ljc/Desktop/Retro/log/log.h", "C++", 47, 0, 0, 3, 12, 62
"/home/ljc/Desktop/Retro/main.cc", "C++", 24, 0, 0, 0, 4, 28
"/home/ljc/Desktop/Retro/sql_pool/sql_connection_pool.cc", "C++", 68, 0, 0, 0, 12, 80
"/home/ljc/Desktop/Retro/sql_pool/sql_connection_pool.h", "C++", 40, 0, 0, 11, 4, 55
"/home/ljc/Desktop/Retro/synchronous.cc", "C++", 59, 0, 0, 5, 14, 78
"/home/ljc/Desktop/Retro/synchronous.h", "C++", 6, 0, 0, 0, 0, 6
"/home/ljc/Desktop/Retro/synchronous/condition_varible.h", "C++", 17, 0, 0, 1, 3, 21
"/home/ljc/Desktop/Retro/synchronous/mutex.h", "C++", 17, 0, 0, 14, 1, 32
"/home/ljc/Desktop/Retro/synchronous/mutex_lock.h", "C++", 11, 0, 0, 3, 2, 16
"/home/ljc/Desktop/Retro/synchronous/sem.h", "C++", 16, 0, 0, 0, 1, 17
"/home/ljc/Desktop/Retro/threadpool/README.md", "Markdown", 0, 0, 6, 0, 9, 15
"/home/ljc/Desktop/Retro/threadpool/threadpool.cc", "C++", 93, 0, 0, 0, 4, 97
"/home/ljc/Desktop/Retro/threadpool/threadpool.h", "C++", 30, 0, 0, 2, 5, 37
"/home/ljc/Desktop/Retro/timer/timer.cc", "C++", 55, 0, 0, 1, 12, 68
"/home/ljc/Desktop/Retro/timer/timer.h", "C++", 56, 0, 0, 7, 22, 85
"/home/ljc/Desktop/Retro/web_server.cc", "C++", 343, 0, 0, 30, 43, 416
"/home/ljc/Desktop/Retro/web_server.h", "C++", 65, 0, 0, 1, 12, 78
"Total", "-", 1867, 24, 6, 135, 305, 2337