"filename", "language", "C++", "Makefile", "Markdown", "HTML", "comment", "blank", "total"
"/home/ljc/Desktop/Retro/Makefile", "Makefile", 0, 26, 0, 0, 0, 3, 29
"/home/ljc/Desktop/Retro/config/config.cc", "C++", 65, 0, 0, 0, 10, 11, 86
"/home/ljc/Desktop/Retro/config/config.h", "C++", 22, 0, 0, 0, 10, 14, 46
"/home/ljc/Desktop/Retro/http/http_event.cc", "C++", 542, 0, 0, 0, 51, 76, 669
"/home/ljc/Desktop/Retro/http/http_event.h", "C++", 136, 0, 0, 0, 0, 10, 146
"/home/ljc/Desktop/Retro/log/block_queue.cc", "C++", 48, 0, 0, 0, 0, 9, 57
"/home/ljc/Desktop/Retro/log/block_queue.h", "C++", 23, 0, 0, 0, 0, 10, 33
"/home/ljc/Desktop/Retro/log/log.cc", "C++", 116, 0, 0, 0, 8, 20, 144
"/home/ljc/Desktop/Retro/log/log.h", "C++", 35, 0, 0, 0, 3, 12, 50
"/home/ljc/Desktop/Retro/main.cc", "C++", 22, 0, 0, 0, 0, 11, 33
"/home/ljc/Desktop/Retro/root/README.md", "Markdown", 0, 0, 10, 0, 0, 1, 11
"/home/ljc/Desktop/Retro/root/fans.html", "HTML", 0, 0, 0, 14, 1, 1, 16
"/home/ljc/Desktop/Retro/root/judge.html", "HTML", 0, 0, 0, 22, 0, 5, 27
"/home/ljc/Desktop/Retro/root/log.html", "HTML", 0, 0, 0, 20, 0, 2, 22
"/home/ljc/Desktop/Retro/root/logError.html", "HTML", 0, 0, 0, 22, 0, 2, 24
"/home/ljc/Desktop/Retro/root/picture.html", "HTML", 0, 0, 0, 14, 1, 1, 16
"/home/ljc/Desktop/Retro/root/register.html", "HTML", 0, 0, 0, 20, 0, 1, 21
"/home/ljc/Desktop/Retro/root/registerError.html", "HTML", 0, 0, 0, 21, 0, 2, 23
"/home/ljc/Desktop/Retro/root/video.html", "HTML", 0, 0, 0, 16, 0, 2, 18
"/home/ljc/Desktop/Retro/root/welcome.html", "HTML", 0, 0, 0, 26, 0, 2, 28
"/home/ljc/Desktop/Retro/sql_pool/sql_connection_pool.cc", "C++", 68, 0, 0, 0, 0, 12, 80
"/home/ljc/Desktop/Retro/sql_pool/sql_connection_pool.h", "C++", 40, 0, 0, 0, 11, 4, 55
"/home/ljc/Desktop/Retro/synchronous.cc", "C++", 59, 0, 0, 0, 5, 14, 78
"/home/ljc/Desktop/Retro/synchronous.h", "C++", 6, 0, 0, 0, 0, 0, 6
"/home/ljc/Desktop/Retro/synchronous/condition_varible.h", "C++", 17, 0, 0, 0, 1, 3, 21
"/home/ljc/Desktop/Retro/synchronous/mutex.h", "C++", 17, 0, 0, 0, 14, 1, 32
"/home/ljc/Desktop/Retro/synchronous/mutex_lock.h", "C++", 11, 0, 0, 0, 3, 2, 16
"/home/ljc/Desktop/Retro/synchronous/sem.h", "C++", 16, 0, 0, 0, 0, 1, 17
"/home/ljc/Desktop/Retro/threadpool/README.md", "Markdown", 0, 0, 6, 0, 0, 9, 15
"/home/ljc/Desktop/Retro/threadpool/threadpool.cc", "C++", 94, 0, 0, 0, 3, 4, 101
"/home/ljc/Desktop/Retro/threadpool/threadpool.h", "C++", 30, 0, 0, 0, 2, 5, 37
"/home/ljc/Desktop/Retro/timer/timer.cc", "C++", 65, 0, 0, 0, 3, 17, 85
"/home/ljc/Desktop/Retro/timer/timer.h", "C++", 49, 0, 0, 0, 5, 20, 74
"/home/ljc/Desktop/Retro/web_server.cc", "C++", 352, 0, 0, 0, 35, 41, 428
"/home/ljc/Desktop/Retro/web_server.h", "C++", 65, 0, 0, 0, 1, 12, 78
"Total", "-", 1898, 26, 16, 175, 167, 340, 2622